-----------------
|     |         |
| -- ---- |     |
|      |     |  |
| ---- | ----   |
| |    |        |
| | ---- ----   |
| |         |   |
| ---- | ----   |
|    | |        |
| -- | ---- --- |
|    |          |
| ---- ---- ----|
|               |
| ----      ----|
|               |
|               |
-----------------