----------------
|     |        |
| ---- ---- |  |
|      |    |  |
| ---- | ----  |
| |    |       |
| | ---- ----  |
| |        |   |
| ---- | ----  |
|    | |       |
| -- | ---- -- |
|    |         |
| ---- ---- ---|
|              |
| ----     ----|
----------------